1111111.
1......1
1.....1.
111111..P
1.....1.
1......1
1......1
1111111.M
