1111111.
1......1
1.....1.
111111..p
1.....1.
1......1
1......1
1111111...e
